100000000000000
111011111111110
011110010100010
001011011111110
011001010101010
001101010110100
110101011011110
010101001010010
011101011011011
000001011110110
010110110101010
010111111010110
001100000110010
010111111111110
000000001000111