000000000000000
001011111111110
011110010100010
001011011111110
011001010101010
001101010110100
110101011011110
010101001010010
011101011011010
000001011110110
010110110101010
010111111010110
001100000110010
010111111111100
000000000000100